txnId,transactionTimestamp,valueDate,narration,type,mode,currentBalance,amount,reference
M12460134,2021-01-04T00:00:00+05:30,2021-01-04,UPI/100304559280/Oid100002510080/paytm-irctcapp@/P,DEBIT,UPI,440609.832,262.08,RF11015412
M12470135,2021-01-04T00:00:00+05:30,2021-01-04,UPI/100437751856/collect/paytm-irctcapp@/Paytm Pay,CREDIT,UPI,441417.912,808.08,RF12015413
M12480136,2021-01-07T00:00:00+05:30,2021-01-07,UPI/100712222548/Skinethics/gpay-1116488882/Axis B,DEBIT,UPI,441117.912,300,RF13015414
M12490137,2021-01-08T00:00:00+05:30,2021-01-08,UPI/100806142513/Oid100002517246/paytm-irctcapp@/P,DEBIT,UPI,440798.538,319.374,RF14015415
M12500138,2021-01-08T00:00:00+05:30,2021-01-08,UPI/100816392006/Pay To RAY OF J/bharatpe.905001/F,DEBIT,UPI,439598.538,1200,RF15015416
M12510139,2021-01-11T00:00:00+05:30,2021-01-11,UPI/100900385229/1mg Technologie/1mgtechnologies/P,DEBIT,UPI,439288.338,310.2,RF16015417
M12520140,2021-01-11T00:00:00+05:30,2021-01-11,NEFT-SBIN321009380660-MR  ND KL AL-/ATTN//INB-0000003325266545,CREDIT,FT,463288.338,24000,RF17015418
M12530141,2021-01-11T00:00:00+05:30,2021-01-11,UPI/100926876678/Oid12508851926@/add-money@paytm/P,DEBIT,UPI,462088.338,1200,RF18015419
M12540142,2021-01-12T00:00:00+05:30,2021-01-12,NEFT-SBIN121012051479-MR  ND KL AL-/ATTN//INB-0000003325266545,CREDIT,FT,708088.338,246000,RF19015420
M12550143,2021-01-13T00:00:00+05:30,2021-01-13,UPI/101307930141/Upi Transaction/moneycontrol.pa/I,DEBIT,UPI,708087.738,0.6,RF20015421
M12560144,2021-01-13T00:00:00+05:30,2021-01-13,MMT/IMPS/101315098813/Farm loan repay/ND A/S,DEBIT,OTHERS,600087.738,108000,RF21015422
M12570145,2021-01-16T00:00:00+05:30,2021-01-16,UPI/101672457697/Payment on Phar/payouts-8725913/P,CREDIT,UPI,600105.738,18,RF22015423
M12580146,2021-01-18T00:00:00+05:30,2021-01-18,UPI/101821218426/BhartiAirtelLim/airtelin.rzp@ic/I,DEBIT,UPI,599776.938,328.8,RF23015424
M12590147,2021-01-18T00:00:00+05:30,2021-01-18,UPI/101823830114/Rewarded for pa/goog-payment@ok/A,CREDIT,UPI,599780.538,3.6,RF24015425
M12600148,2021-01-21T00:00:00+05:30,2021-01-21,NEFT-AXISCN0066982711-AXIS MUTUAL FUND REDEMPTION POOL A-CUST AXIS MUTUAL FUND ,CREDIT,FT,611780.538,12000,RF25015426
M12610149,2021-01-22T00:00:00+05:30,2021-01-22,NEFT-001ONCF21022A703-BARCLAYS GLOBAL SERVICE CENT,CREDIT,FT,702721.338,90940.8,RF26015427
M12620150,2021-01-25T00:00:00+05:30,2021-01-25,UPI/102301596668/Payment from Ph/bhartiairtel.rz/S,DEBIT,UPI,702715.338,6,RF27015428
M12630151,2021-01-25T00:00:00+05:30,2021-01-25,UPI/102314394935/BhartiAirtelLim/bhartiairtel.rz/S,DEBIT,UPI,702685.938,29.4,RF28015429
M12640152,2021-01-25T00:00:00+05:30,2021-01-25,UPI/102419241494/credit card bil/cred.ccbp@yesba/Y,DEBIT,UPI,698742.75,3943.188,RF29015430
M12650153,2021-01-25T00:00:00+05:30,2021-01-25,UPI/102567354483/Oid100002544108/paytm-irctcapp@/P,DEBIT,UPI,698044.59,698.16,RF30015431
M12660154,2021-02-01T00:00:00+05:30,2021-02-01,UPI/103109101955/Haircut/paytmqr28100505/Paytm Pay,DEBIT,UPI,697972.59,72,RF31015432
M12670155,2021-02-01T00:00:00+05:30,2021-02-01,NEFT-SBIN421031387729-MR  ND KL AL-/ATTN//INB-0000003325266545,CREDIT,FT,703972.59,6000,RF32015433
M12680156,2021-02-01T00:00:00+05:30,2021-02-01,MMT/IMPS/103123598125/MOBLT3101230964/NAVRANG KE/S,CREDIT,OTHERS,752572.59,48600,RF33015434
M12690157,2021-02-01T00:00:00+05:30,2021-02-01,NEFT-0811OP1008373273-AAKASH ND AL--881,CREDIT,FT,808925.19,56352.6,RF34015435
M12700158,2021-02-01T00:00:00+05:30,2021-02-01,BIL/NEFT/000033122431/Edu Loan Repaym/NAVRANG BH/S,DEBIT,OTHERS,796925.19,12000,RF35015436
M12710159,2021-02-01T00:00:00+05:30,2021-02-01,NEFT-AXISCN0067795779-AXIS MUTUAL FUND REDEMPTION POOL A-CUST AXIS MUTUAL FUND ,CREDIT,FT,808925.19,12000,RF36015437
M12720160,2021-02-03T00:00:00+05:30,2021-02-03,UPI/103418492958/Baddy/er.amitparsuram/ICICI Bank ,DEBIT,UPI,807965.19,960,RF37015438
M12730161,2021-02-06T00:00:00+05:30,2021-02-06,UPI/103725588679/Oid100002563181/paytm-irctcapp@/P,DEBIT,UPI,807700.11,265.08,RF38015439
M12740162,2021-02-06T00:00:00+05:30,2021-02-06,UPI/103725759682/Oid100002563181/paytm-irctcapp@/P,DEBIT,UPI,807639.03,61.08,RF39015440
M12750163,2021-02-06T00:00:00+05:30,2021-02-06,UPI/103725895479/Oid100002563181/paytm-irctcapp@/P,DEBIT,UPI,807577.95,61.08,RF40015441
M12760164,2021-02-09T00:00:00+05:30,2021-02-09,UPI/104011370951/AL Stitch/drklchaudhari19/Ba,DEBIT,UPI,807067.95,510,RF41015442
M12770165,2021-02-10T00:00:00+05:30,2021-02-10,UPI/104112274066/Start buy/nk@ic/IC,DEBIT,UPI,789067.95,18000,RF42015443
M12780166,2021-02-10T00:00:00+05:30,2021-02-10,BIL/ONL/000042180840/Redbus/wwwredbusin1226/Mum bu,DEBIT,OTHERS,788833.95,234,RF43015444
M12790167,2021-02-10T00:00:00+05:30,2021-02-10,BIL/ONL/000042248540/Zomato Med/zoma01210203566/Bi,DEBIT,OTHERS,788262.3,571.65,RF44015445
M12800168,2021-02-12T00:00:00+05:30,2021-02-12,UPI/104315149103/chocs/paytmqr28100505/Paytm Payme,DEBIT,UPI,787803.3,459,RF45015446
M12810169,2021-02-15T00:00:00+05:30,2021-02-15,UPI/104415230274/UPI/dominospizzaonl/Paytm Payment,DEBIT,UPI,787402.5,400.8,RF46015447
M12820170,2021-02-15T00:00:00+05:30,2021-02-15,UPI/104512312086/food/paytmqr28100505/Paytm Paymen,DEBIT,UPI,787304.7,97.8,RF47015448
M12830171,2021-02-15T00:00:00+05:30,2021-02-15,UPI/104513196058/IndiGo Razor Pa/goindigo.razorp/H,DEBIT,UPI,787214.7,90,RF48015449
M12840172,2021-02-15T00:00:00+05:30,2021-02-15,UPI/104634064439/Oid100002579851/paytm-irctcapp@/P,DEBIT,UPI,786429.246,785.454,RF49015450
M12850173,2021-02-15T00:00:00+05:30,2021-02-15,BIL/NEFT/000045407461/Papa for home/ND A/SBI,DEBIT,OTHERS,783429.246,3000,RF50015451
M12860174,2021-02-15T00:00:00+05:30,2021-02-15,UPI/104652586986/Oid100002581676/paytm-irctcapp@/P,DEBIT,UPI,783335.166,94.08,RF51015452
M12870175,2021-02-16T00:00:00+05:30,2021-02-16,NEFT-SBIN421047154109-SBI FUNDS MANAGEMENT PRIVATE LIMITE-/ATTN//INB-0000004000,CREDIT,FT,789728.382,6393.216,RF52015453
M12880176,2021-02-17T00:00:00+05:30,2021-02-17,UPI/104896439778/collect/paytm-irctcapp@/Paytm Pay,CREDIT,UPI,789746.382,18,RF53015454
M12890177,2021-02-18T00:00:00+05:30,2021-02-18,UPI/104911390814/UPI/olamoney1.rzp@a/Axis Bank Ltd,DEBIT,UPI,789616.782,129.6,RF54015455
M12900178,2021-02-19T00:00:00+05:30,2021-02-19,UPI/105045684514/Payment from Ph/bigbasket@axisb/A,DEBIT,UPI,789484.782,132,RF55015456
M12910179,2021-02-19T00:00:00+05:30,2021-02-19,CMS/ SR197330840 M3307344/SME AND AGRI GROUP      ,CREDIT,OTHERS,789499.782,15,RF56015457
M12920180,2021-02-23T00:00:00+05:30,2021-02-23,UPI/105429632071/Payment from Ph/payu@axisbank/Axi,DEBIT,UPI,789469.782,30,RF57015458
M12930181,2021-02-23T00:00:00+05:30,2021-02-23,BIL/ONL/000051486803/cred.club/wwwcredclub1236/cc ,DEBIT,OTHERS,782880.582,6589.2,RF58015459
M12940182,2021-02-24T00:00:00+05:30,2021-02-24,NEFT-001ONCF21055B081-BARCLAYS GLOBAL SERVICE CENT,CREDIT,FT,874305.582,91425,RF59015460
M12950183,2021-02-25T00:00:00+05:30,2021-02-25,UPI/105614241892/LE TRAVENUES TE/ixigo.rzp@axisb/A,DEBIT,UPI,873316.782,988.8,RF60015461
M12960184,2021-02-25T00:00:00+05:30,2021-02-25,UPI/105614003172/Upi Transaction/ixigo@indus/INDUS,DEBIT,UPI,872516.982,799.8,RF61015462
M12970185,2021-02-26T00:00:00+05:30,2021-02-26,UPI/105717397840/Refund/ixigo@indus/INDUSIND BANK ,CREDIT,UPI,872917.632,400.65,RF62015463
M12980186,2021-03-01T00:00:00+05:30,2021-03-01,UPI/105818292295/pav/paytmqr28100505/Paytm Payment,DEBIT,UPI,872896.032,21.6,RF63015464
M12990187,2021-03-01T00:00:00+05:30,2021-03-01,UPI/105818637528/UPI/goog-payment@ok/Axis Bank Ltd,CREDIT,UPI,872898.432,2.4,RF64015465
M13000188,2021-03-01T00:00:00+05:30,2021-03-01,BIL/NEFT/000055596410/Edu Loan Repaym/NAVRANG BH/S,DEBIT,OTHERS,860898.432,12000,RF65015466
M13010189,2021-03-01T00:00:00+05:30,2021-03-01,CLG/LIFE INSURANCE CORPORATIO                     ,DEBIT,OTHERS,816562.032,44336.4,RF66015467
M13020190,2021-03-01T00:00:00+05:30,2021-03-01,BIL/ONL/000056410312/Redbus/wwwredbusin1240/Bus tk,DEBIT,OTHERS,815995.032,567,RF67015468
M13030191,2021-03-01T00:00:00+05:30,2021-03-01,UPI/106016831953/UPI Transaction/redbus.payu@axi/A,DEBIT,UPI,815335.632,659.4,RF68015469
M13040192,2021-03-02T00:00:00+05:30,2021-03-02,BIL/ONL/000057164189/CRED CLUB/DP-6RaG1PayN5xl    ,DEBIT,OTHERS,779548.032,35787.6,RF69015470
M13050193,2021-03-02T00:00:00+05:30,2021-03-02,UPI/106156490541/Payment from Ph/credcc@yesbank/Ye,DEBIT,UPI,777478.632,2069.4,RF70015471
M13060194,2021-03-06T00:00:00+05:30,2021-03-06,UPI/106516470391/chocs/paytmqr28100505/Paytm Payme,DEBIT,UPI,777409.632,69,RF71015472
M13070195,2021-03-06T00:00:00+05:30,2021-03-06,UPI/106516490094/meds/q15031254@ybl/Canara Bank   ,DEBIT,UPI,777366.432,43.2,RF72015473
M13080196,2021-03-08T00:00:00+05:30,2021-03-08,BIL/INFT/000062173555/Flat/                       ,DEBIT,OTHERS,537366.432,240000,RF73015474
M13090197,2021-03-08T00:00:00+05:30,2021-03-08,DD/CC ISSUED-*** LIC HFL PUNE ***-PUNE - BALEWADI ,DEBIT,OTHERS,533791.032,3575.4,RF74015475
M13100198,2021-03-08T00:00:00+05:30,2021-03-08,NEFT-CITIN21137741385-UIIC HEALTH PAYMENTS-5007002820C057205002 DOA27012021-010,CREDIT,FT,544220.232,10429.2,RF75015476
M13110199,2021-03-08T00:00:00+05:30,2021-03-08,UPI/106713139953/baddy march/er.amitparsuram/HDFC ,DEBIT,UPI,543152.232,1068,RF76015477
M13120200,2021-03-08T00:00:00+05:30,2021-03-08,UPI/106713748403/UPI/goog-payment@ok/Axis Bank Ltd,CREDIT,UPI,543154.632,2.4,RF77015478
M13130201,2021-03-08T00:00:00+05:30,2021-03-08,UPI/106758833223/Oid100002617240/paytm-irctcapp@/P,DEBIT,UPI,542213.472,941.16,RF78015479
M13140202,2021-03-08T00:00:00+05:30,2021-03-08,UPI/106758833223/Oid100002617240/paytm-irctcapp@/P,CREDIT,UPI,543154.632,941.16,RF79015480
M13150203,2021-03-08T00:00:00+05:30,2021-03-08,UPI/106758833223/Oid100002617240/paytm-irctcapp@/P,DEBIT,UPI,542213.472,941.16,RF80015481
M13160204,2021-03-08T00:00:00+05:30,2021-03-08,UPI/106791476498/Collect request/irctc@ybl/Yes Ban,DEBIT,UPI,541272.312,941.16,RF81015482
M13170205,2021-03-09T00:00:00+05:30,2021-03-09,UPI 106758833223 Oid100002617240 paytm irctcapp  P,CREDIT,OTHERS,542213.472,941.16,RF82015483
M13180206,2021-03-09T00:00:00+05:30,2021-03-09,BIL/NEFT/000064221973/Home Down Payme/RAJENDRA H/N,DEBIT,OTHERS,422213.472,120000,RF83015484
M13190207,2021-03-09T00:00:00+05:30,2021-03-09,BIL/NEFT/000064222641/Home Down Payme/RAJENDRA H/N,DEBIT,OTHERS,362213.472,60000,RF84015485
M13200208,2021-03-09T00:00:00+05:30,2021-03-09,BIL/NEFT/000064223251/Home Down Payme/SAVITA RAJ/N,DEBIT,OTHERS,242213.472,120000,RF85015486
M13210209,2021-03-09T00:00:00+05:30,2021-03-09,BIL/NEFT/000064223805/NA/SAVITA RAJ/NMCB0000055   ,DEBIT,OTHERS,182213.472,60000,RF86015487
M13220210,2021-03-09T00:00:00+05:30,2021-03-09,BIL/NEFT/000064224487/Home Down Payme/CHAITANYA /C,DEBIT,OTHERS,77213.472,105000,RF87015488
M13230211,2021-03-10T00:00:00+05:30,2021-03-10,UPI/106900762495/PhonePe Reversa/phonepemerchant/Y,CREDIT,UPI,78154.632,941.16,RF88015489
M13240212,2021-03-10T00:00:00+05:30,2021-03-10,UPI/106984653985/Payment from Ph/yatra1@indus/INDU,DEBIT,UPI,77713.632,441,RF89015490
M13250213,2021-03-10T00:00:00+05:30,2021-03-10,MMT/IMPS/106911567559/MOBLT1003113827/NAVRANG KE/S,CREDIT,OTHERS,197713.632,120000,RF90015491
M13260214,2021-03-10T00:00:00+05:30,2021-03-10,BIL/INFT/000064767016/Personal/                   ,CREDIT,OTHERS,744313.632,546600,RF91015492
M13270215,2021-03-10T00:00:00+05:30,2021-03-10,BIL/NEFT/000064786108/Home Down Payme/RAJENDRA H/N,DEBIT,OTHERS,437713.632,306600,RF92015493
M13280216,2021-03-10T00:00:00+05:30,2021-03-10,BIL/NEFT/000064786840/Home Down Payme/SAVITA RAJ/N,DEBIT,OTHERS,197713.632,240000,RF93015494
M13290217,2021-03-10T00:00:00+05:30,2021-03-10,BIL/REV PMT ID 56410312                           ,CREDIT,OTHERS,198226.632,513,RF94015495
M13300218,2021-03-10T00:00:00+05:30,2021-03-10,UPI/106917351364/UPI/makemytrip@icic/ICICI Bank   ,DEBIT,UPI,197612.232,614.4,RF95015496
M13310219,2021-03-10T00:00:00+05:30,2021-03-10,UPI/106917492333/Refund/yatra1@indus/INDUSIND BANK,CREDIT,UPI,198009.132,396.9,RF96015497
M13320220,2021-03-11T00:00:00+05:30,2021-03-11,BIL/INFT/000065311699/Personal/                   ,CREDIT,OTHERS,438009.132,240000,RF97015498
M13330221,2021-03-11T00:00:00+05:30,2021-03-11,BIL/NEFT/000065313165/Home Down Payme/CHAITANYA /C,DEBIT,OTHERS,198009.132,240000,RF98015499
M13340222,2021-03-11T00:00:00+05:30,2021-03-11,UPI/107068610435/Payment from Ph/uberrides@hdfcb/H,DEBIT,UPI,197847.132,162,RF99015500
M13350223,2021-03-11T00:00:00+05:30,2021-03-11,UPI/107011257002/charge/uber@axisbank/Axis Bank Lt,DEBIT,UPI,197846.532,0.6,RF100015501
M13360224,2021-03-11T00:00:00+05:30,2021-03-11,UPI/107011426998/UPI/goog-payment@ok/Axis Bank Ltd,CREDIT,UPI,197849.532,3,RF101015502
M13370225,2021-03-11T00:00:00+05:30,2021-03-11,BIL/ONL/000065613159/Zomato Med/zoma01210303629/Bi,DEBIT,OTHERS,197579.784,269.748,RF102015503
M13380226,2021-03-11T00:00:00+05:30,2021-03-11,UPI/107017473428/tossin/paytmqr28100505/Paytm Paym,DEBIT,UPI,197393.184,186.6,RF103015504
M13390227,2021-03-11T00:00:00+05:30,2021-03-11,UPI/107018128494/roll/paytmqr28100505/Paytm Paymen,DEBIT,UPI,197315.184,78,RF104015505
M13400228,2021-03-11T00:00:00+05:30,2021-03-11,UPI/107020414040/UberRide/uberrides@hdfcb/HDFC BAN,DEBIT,UPI,197066.184,249,RF105015506
M13410229,2021-03-12T00:00:00+05:30,2021-03-12,BIL/INFT/000066278458/Personal/                   ,CREDIT,OTHERS,797066.184,600000,RF106015507
M13420230,2021-03-12T00:00:00+05:30,2021-03-12,BIL/NEFT/000066290681/Home Down Payme/RAJENDRA H/N,DEBIT,OTHERS,557066.184,240000,RF107015508
M13430231,2021-03-12T00:00:00+05:30,2021-03-12,BIL/NEFT/000066291398/Home Down Payme/CHAITANYA /C,DEBIT,OTHERS,377066.184,180000,RF108015509
M13440232,2021-03-12T00:00:00+05:30,2021-03-12,BIL/NEFT/000066291997/Home Down Payme/SAVITA RAJ/N,DEBIT,OTHERS,197066.184,180000,RF109015510
M13450233,2021-03-12T00:00:00+05:30,2021-03-12,UPI 107011257002 11 03 2021 AXB                   ,CREDIT,OTHERS,197066.784,0.6,RF110015511
M13460234,2021-03-15T00:00:00+05:30,2021-03-15,UPI/107309093386/UPI/mehtaabhinav007/HDFC BANK LTD,CREDIT,UPI,197126.784,60,RF111015512
M13470235,2021-03-15T00:00:00+05:30,2021-03-15,UPI/107407053248/UberRide/uberrides@hdfcb/HDFC BAN,DEBIT,UPI,197084.184,42.6,RF112015513
M13480236,2021-03-15T00:00:00+05:30,2021-03-15,UPI/107412477270/UberRide/uberrides@hdfcb/HDFC BAN,DEBIT,UPI,196972.584,111.6,RF113015514
M13490237,2021-03-15T00:00:00+05:30,2021-03-15,UPI/107412069233/covid test/ayugenbio@icici/ICICI ,DEBIT,UPI,196462.584,510,RF114015515
M13500238,2021-03-15T00:00:00+05:30,2021-03-15,BIL/INFT/000068514721/NA/                         ,CREDIT,OTHERS,316462.584,120000,RF115015516
M13510239,2021-03-15T00:00:00+05:30,2021-03-15,BIL/NEFT/000068523876/StampDutyDHCFee/AJINKYA DE/B,DEBIT,OTHERS,2902.584,313560,RF116015517
M13520240,2021-03-16T00:00:00+05:30,2021-03-16,NEFT-AXISCN0072654572-AXIS MUTUAL FUND REDEMPTION POOL A-CUST AXIS MUTUAL FUND ,CREDIT,FT,41518.254,38615.67,RF117015518
M13530241,2021-03-16T00:00:00+05:30,2021-03-16,NEFT-AXISCN0072649807-AXIS MUTUAL FUND REDEMPTION POOL A-CUST AXIS MUTUAL FUND ,CREDIT,FT,98750.046,57231.792,RF118015519
M13540242,2021-03-16T00:00:00+05:30,2021-03-16,NEFT-N075211440618392-MIRAE ASSET MF REDEMPTION A C-00000000000001370951-006003,CREDIT,FT,144830.526,46080.48,RF119015520
M13550243,2021-03-16T00:00:00+05:30,2021-03-16,UPI/107521165236/Wikimedia 877 6/cashfree@hdfcba/H,DEBIT,UPI,144783.126,47.4,RF120015521
M13560244,2021-03-17T00:00:00+05:30,2021-03-17,UPI/107611276212/train tkt/preettravels07@/State B,DEBIT,UPI,138843.126,5940,RF121015522
M13570245,2021-03-19T00:00:00+05:30,2021-03-19,BIL/INFT/000071260159/Return/                     ,DEBIT,OTHERS,18843.126,120000,RF122015523
M13580246,2021-03-19T00:00:00+05:30,2021-03-19,UPI/107815006831/UberRide/uberrides@hdfcb/HDFC BAN,DEBIT,UPI,18642.126,201,RF123015524
M13590247,2021-03-19T00:00:00+05:30,2021-03-19,UPI/107816808917/charge/uberrides@hdfcb/HDFC BANK ,DEBIT,UPI,18549.126,93,RF124015525
M13600248,2021-03-22T00:00:00+05:30,2021-03-22,UPI/108017678455/YouTube Videos/googlepay@axisb/Ax,DEBIT,UPI,18534.126,15,RF125015526
M13610249,2021-03-24T00:00:00+05:30,2021-03-24,NEFT-001ONCF210836491-BARCLAYS GLOBAL SERVICE CENT,CREDIT,FT,253174.326,234640.2,RF126015527
M13620250,2021-03-24T00:00:00+05:30,2021-03-24,UPI/108313274324/UPI/makemytrip@icic/ICICI Bank   ,DEBIT,UPI,252701.826,472.5,RF127015528
M13630251,2021-03-29T00:00:00+05:30,2021-03-29,DCardfee2458MAR21-FEB22+GST                       ,DEBIT,OTHERS,252277.734,424.092,RF128015529
M13640252,2021-03-29T00:00:00+05:30,2021-03-29,UPI/108711187452/haircut/paytmqr28100505/Paytm Pay,DEBIT,UPI,252205.734,72,RF129015530
M13650253,2021-03-30T00:00:00+05:30,2021-03-30,238801500178:Int.Pd:30-12-2020 to 29-03-2021      ,CREDIT,OTHERS,256365.534,4159.8,RF130015531
M13660254,2021-03-31T00:00:00+05:30,2021-03-31,BIL/ONL/000080082981/CRED CLUB/DP-7byezPlMxxzj/CC ,DEBIT,OTHERS,245743.134,10622.4,RF131015532
M13670255,2021-03-31T00:00:00+05:30,2021-03-31,UPI/109061676029/Payment from Ph/credcc@yesbank/Ye,DEBIT,UPI,241669.602,4073.532,RF132015533
M13680256,2021-03-31T00:00:00+05:30,2021-03-31,NEFT-000000195754-SAWANT RAJENDRA HIRAMAN-/URGENT/,CREDIT,FT,297019.602,55350,RF133015534
M13690257,2021-04-02T00:00:00+05:30,2021-04-02,BIL/NEFT/000080787540/Edu Loan Repaym/NAVRANG BH/S,DEBIT,OTHERS,285019.602,12000,RF134015535
M13700258,2021-04-02T00:00:00+05:30,2021-04-02,UPI/109116038059/UberRide/uberrides@hdfcb/HDFC BAN,DEBIT,UPI,284911.002,108.6,RF135015536
M13710259,2021-04-02T00:00:00+05:30,2021-04-02,UPI/109111159218/Upi Transaction/fnp.payu@hdfcba/H,DEBIT,UPI,284581.002,330,RF136015537
M13720260,2021-04-02T00:00:00+05:30,2021-04-02,UPI/109267046480/Oid13198338289@/add-money@paytm/P,DEBIT,UPI,283381.002,1200,RF137015538
M13730261,2021-04-05T00:00:00+05:30,2021-04-05,UPI/109406211084/Auto/amzn0020388725@/Kotak Mahind,DEBIT,UPI,283285.002,96,RF138015539
M13740262,2021-04-05T00:00:00+05:30,2021-04-05,UPI/109412355999/Meds/gpay-1118037476/Axis Bank Lt,DEBIT,UPI,283231.602,53.4,RF139015540
M13750263,2021-04-05T00:00:00+05:30,2021-04-05,UPI/109416888775/Zipcash card se/ola.money1@axis/A,DEBIT,UPI,283132.602,99,RF140015541
M13760264,2021-04-05T00:00:00+05:30,2021-04-05,GIB/000061264176/DTAX      /639034004042101972    ,DEBIT,OTHERS,273907.602,9225,RF141015542
M13770265,2021-04-05T00:00:00+05:30,2021-04-05,GIB/000061264228/DTAX      /639034004042101992    ,DEBIT,OTHERS,264682.602,9225,RF142015543
M13780266,2021-04-05T00:00:00+05:30,2021-04-05,GIB/000061264267/DTAX      /639034004042102010    ,DEBIT,OTHERS,255461.202,9221.4,RF143015544
M13790267,2021-04-05T00:00:00+05:30,2021-04-05,GIB/000061264296/DTAX      /639034004042102020    ,DEBIT,OTHERS,246238.002,9223.2,RF144015545
M13800268,2021-04-05T00:00:00+05:30,2021-04-05,GIB/000061264324/DTAX      /639034004042102036    ,DEBIT,OTHERS,237013.002,9225,RF145015546
M13810269,2021-04-05T00:00:00+05:30,2021-04-05,GIB/000061264344/DTAX      /639034004042102053    ,DEBIT,OTHERS,227788.002,9225,RF146015547
M13820270,2021-04-05T00:00:00+05:30,2021-04-05,UPI/109420122306/UPI Payment-Buy/nik@ic/I,DEBIT,UPI,209788.002,18000,RF147015548
M13830271,2021-04-05T00:00:00+05:30,2021-04-05,CLG/LIC HOUSING FINANCE LIMIT                     ,DEBIT,OTHERS,204407.202,5380.8,RF148015549
M13840272,2021-04-07T00:00:00+05:30,2021-04-07,UPI/109709393337/cashback deal/suman71911@okic/ICI,CREDIT,UPI,204409.002,1.8,RF149015550
M13850273,2021-04-07T00:00:00+05:30,2021-04-07,UPI/109714477488/UPI/suman71911@okic/ICICI Bank   ,DEBIT,UPI,204406.902,2.1,RF150015551
M13860274,2021-04-07T00:00:00+05:30,2021-04-07,UPI/109721484266/Nepali currency/chetan15994@oks/S,CREDIT,UPI,209266.902,4860,RF151015552
M13870275,2021-04-07T00:00:00+05:30,2021-04-07,UPI/109721499829/NPR FX Settle/kaushal321993@o/Sta,DEBIT,UPI,207466.902,1800,RF152015553
M13880276,2021-04-07T00:00:00+05:30,2021-04-07,UPI/109721008101/NPR FX Settle/goodmorning.143/ICI,DEBIT,UPI,204466.902,3000,RF153015554
M13890277,2021-04-07T00:00:00+05:30,2021-04-07,UPI/109721049365/NPR FX Commissi/suman71911@okic/I,DEBIT,UPI,204436.902,30,RF154015555
M13900278,2021-04-12T00:00:00+05:30,2021-04-12,UPI/110071934711/Payment from Ph/paytm-1425436@p/P,DEBIT,UPI,204321.402,115.5,RF155015556
M13910279,2021-04-12T00:00:00+05:30,2021-04-12,UPI/110117025808/Paying to Balle/ballebaazi@payt/P,DEBIT,UPI,204261.402,60,RF156015557
M13920280,2021-04-12T00:00:00+05:30,2021-04-12,UPI/110216716430/UPI/goog-payment@ok/Axis Bank Ltd,CREDIT,UPI,204265.002,3.6,RF157015558
M13930281,2021-04-12T00:00:00+05:30,2021-04-12,NEFT-SBIN221102860118-SBI FUNDS MANAGEMENT PRIVATE LIMITE-/ATTN//INB-0000004000,CREDIT,FT,206140.674,1875.672,RF158015559
M13940282,2021-04-13T00:00:00+05:30,2021-04-13,UPI/110308680685/Payment from Ph/airtelin.rzp@ic/I,DEBIT,UPI,205811.874,328.8,RF159015560
M13950283,2021-04-14T00:00:00+05:30,2021-04-14,UPI/110417119459/settle/avnigupta2590@o/ICICI Bank,DEBIT,UPI,204551.874,1260,RF160015561
M13960284,2021-04-14T00:00:00+05:30,2021-04-14,UPI/110417651940/ICICI Prudentia/iciciprudential/S,DEBIT,UPI,184123.674,20428.2,RF161015562
M13970285,2021-04-15T00:00:00+05:30,2021-04-15,ACH/LICHOUSINGFINLTD/620500010790:24137146        ,DEBIT,FT,181249.074,2874.6,RF162015563
M13980286,2021-04-17T00:00:00+05:30,2021-04-17,UPI/110713270064/MAHAGVECPR/billdesk@hdfcba/HDFC B,DEBIT,UPI,180949.074,300,RF163015564
M13990287,2021-04-17T00:00:00+05:30,2021-04-17,UPI/110721967111/MAHAGVECPR/billdesk@hdfcba/HDFC B,DEBIT,UPI,179149.074,1800,RF164015565
M14000288,2021-04-19T00:00:00+05:30,2021-04-19,BIL/INFT/000095823876/Family/                     ,CREDIT,OTHERS,299149.074,120000,RF165015566
M14010289,2021-04-19T00:00:00+05:30,2021-04-19,BIL/NEFT/000095825714/Lent to Sawant/RAJENDRA S/BA,DEBIT,OTHERS,119149.074,180000,RF166015567
M14020290,2021-04-19T00:00:00+05:30,2021-04-19,NEFT-SBIN221109344748-MR  ND KL AL-/ATTN//INB-0000003325266545,CREDIT,FT,179149.074,60000,RF167015568
M14030291,2021-04-23T00:00:00+05:30,2021-04-23,NEFT-001ONCF211136883-BARCLAYS GLOBAL SERVICE CENT,CREDIT,FT,269173.674,90024.6,RF168015569
M14040292,2021-04-26T00:00:00+05:30,2021-04-26,BIL/INFT/000099126696/For carpenter/              ,DEBIT,OTHERS,239173.674,30000,RF169015570
M14050293,2021-04-26T00:00:00+05:30,2021-04-26,UPI/111619081673/electrician/lokhanderahul38/State,DEBIT,UPI,238993.674,180,RF170015571
M14060294,2021-04-28T00:00:00+05:30,2021-04-28,UPI/111847688822/Payment from Ph/jagtapnilesh83@/J,DEBIT,UPI,220993.674,18000,RF171015572
M14070295,2021-04-28T00:00:00+05:30,2021-04-28,UPI/111856334235/Payment from Ph/airtelin.rzp@ax/A,DEBIT,UPI,220934.874,58.8,RF172015573
M14080296,2021-04-28T00:00:00+05:30,2021-04-28,UPI/111890785248/Payment from Ph/HOTSTARONLINE@y/Y,DEBIT,UPI,220695.474,239.4,RF173015574
M14090297,2021-04-29T00:00:00+05:30,2021-04-29,UPI/111911070352/2 pillows/avnigupta2590@o/ICICI B,CREDIT,UPI,221055.474,360,RF174015575
M14100298,2021-04-30T00:00:00+05:30,2021-04-30,UPI/112014359709/credit card bil/credcc@yesbank/Ye,DEBIT,UPI,215137.674,5917.8,RF175015576
M14110299,2021-04-30T00:00:00+05:30,2021-04-30,BIL/ONL/000103105234/CRED CLUB/DP-mY5qxVZ92bag    ,DEBIT,OTHERS,170260.668,44877.006,RF176015577
M14120300,2021-05-01T00:00:00+05:30,2021-05-01,BIL/NEFT/000103672970/Edu Loan Repaym/NAVRANG BH/S,DEBIT,OTHERS,158260.668,12000,RF177015578
M14130301,2021-05-01T00:00:00+05:30,2021-05-01,UPI/112110639536/UPI/raisinghani.hem/HDFC BANK LTD,CREDIT,UPI,182260.668,24000,RF178015579
M14140302,2021-05-01T00:00:00+05:30,2021-05-01,UPI/112111224500/UPI/paytm-48097969@/Paytm Payment,DEBIT,UPI,181960.668,300,RF179015580
M14150303,2021-05-03T00:00:00+05:30,2021-05-03,NEFT-SBIN221123937949-SBI FUNDS MANAGEMENT PRIVATE LIMITE-/ATTN//INB-0000004000,CREDIT,FT,182932.518,971.85,RF180015581
M14160304,2021-05-06T00:00:00+05:30,2021-05-06,BIL/INFT/000108660329/Home/                       ,DEBIT,OTHERS,167932.518,15000,RF181015582
M14170305,2021-05-07T00:00:00+05:30,2021-05-07,BIL/INFT/000110011763/Deepa/                      ,DEBIT,OTHERS,161932.518,6000,RF182015583
M14180306,2021-05-10T00:00:00+05:30,2021-05-10,BIL/ONL/000111403204/Zomato Med/zoma01210503756/Ro,DEBIT,OTHERS,161302.878,629.64,RF183015584
M14190307,2021-05-10T00:00:00+05:30,2021-05-10,UPI/112989166314/Payment from Ph/upiswiggy@icici/I,DEBIT,UPI,161119.278,183.6,RF184015585
M14200308,2021-05-12T00:00:00+05:30,2021-05-12,UPI/113206920337/Meds/Q59499692@ybl/Paytm Payments,DEBIT,UPI,161102.478,16.8,RF185015586
M14210309,2021-05-13T00:00:00+05:30,2021-05-13,UPI/113310349214/Payment from Ph/9657739012@ybl/HD,DEBIT,UPI,143102.478,18000,RF186015587
M14220310,2021-05-13T00:00:00+05:30,2021-05-13,UPI/113342354601/Payment from Ph/jagtapnilesh83@/J,DEBIT,UPI,131102.478,12000,RF187015588
M14230311,2021-05-13T00:00:00+05:30,2021-05-13,UPI/113316100224/UPI/raisinghani.hem/HDFC BANK LTD,CREDIT,UPI,137102.478,6000,RF188015589
M14240312,2021-05-15T00:00:00+05:30,2021-05-15,ACH/LICHOUSINGFINLTD/620500010790:24928228        ,DEBIT,FT,91027.278,46075.2,RF189015590
M14250313,2021-05-17T00:00:00+05:30,2021-05-17,BIL/NEFT/000115980575/Hostel Fees/SVKM'S NMI/KKBK0,DEBIT,OTHERS,57547.278,33480,RF190015591
M14260314,2021-05-19T00:00:00+05:30,2021-05-19,UPI/113904149008/Collect request/irctc@ybl/Yes Ban,DEBIT,UPI,56213.118,1334.16,RF191015592
M14270315,2021-05-20T00:00:00+05:30,2021-05-20,UPI/114068000895/Collect request/billdesktatasky/Y,DEBIT,UPI,55913.118,300,RF192015593
M14280316,2021-05-20T00:00:00+05:30,2021-05-20,NEFT-BARBS21140627191-RAJENDRA HIRAMAN SAWANT--278,CREDIT,FT,211913.118,156000,RF193015594
M14290317,2021-05-20T00:00:00+05:30,2021-05-20,BIL/INFT/000118548016/Return/                     ,DEBIT,OTHERS,91913.118,120000,RF194015595
M14300318,2021-05-21T00:00:00+05:30,2021-05-21,UPI/114117559644/Payment from Ph/vishalbamgude@y/I,CREDIT,UPI,97913.118,6000,RF195015596
M14310319,2021-05-21T00:00:00+05:30,2021-05-21,UPI/114191108783/Payment from Ph/bhartiairtel.rz/S,DEBIT,UPI,97762.518,150.6,RF196015597
M14320320,2021-05-21T00:00:00+05:30,2021-05-21,UPI/114142336120/Payment from Ph/credclub@icici/IC,DEBIT,UPI,84409.944,13352.574,RF197015598
M14330321,2021-05-24T00:00:00+05:30,2021-05-24,INF/INFT/20210523180726/Self                      ,DEBIT,OTHERS,83209.944,1200,RF198015599
M14340322,2021-05-24T00:00:00+05:30,2021-05-24,NEFT-001ONCF21144A72U-BARCLAYS GLOBAL SERVICE CENT,CREDIT,FT,173235.144,90025.2,RF199015600
M14350323,2021-05-24T00:00:00+05:30,2021-05-24,UPI/114457199314/Payment from Ph/jagtapnilesh83@/J,DEBIT,UPI,172035.144,1200,RF200015601
M14360324,2021-05-24T00:00:00+05:30,2021-05-24,UPI/114415897536/Upi Transaction/bajajallianz.pa/H,DEBIT,UPI,166947.744,5087.4,RF201015602
M14370325,2021-05-27T00:00:00+05:30,2021-05-27,UPI/114721545552/YOUBROADBAND/billdesk@hdfcba/HDFC,DEBIT,UPI,165329.544,1618.2,RF202015603
M14380326,2021-05-31T00:00:00+05:30,2021-05-31,UPI/115011224027/train tkt/preettravels07@/State B,DEBIT,UPI,161729.544,3600,RF203015604
M14390327,2021-05-31T00:00:00+05:30,2021-05-31,UPI/115012240881/trail tkt/preettravels07@/State B,DEBIT,UPI,160349.544,1380,RF204015605
M14400328,2021-05-31T00:00:00+05:30,2021-05-31,UPI/115015492464/Payment from Ph/credclub@icici/IC,DEBIT,UPI,135104.544,25245,RF205015606
M14410329,2021-05-31T00:00:00+05:30,2021-05-31,UPI/115078157464/Payment from Ph/credcc@yesbank/Ye,DEBIT,UPI,126751.488,8353.056,RF206015607
M14420330,2021-06-01T00:00:00+05:30,2021-06-01,BIL/NEFT/000125879615/Edu Loan Repaym/NAVRANG BH/S,DEBIT,OTHERS,114751.488,12000,RF207015608
M14430331,2021-06-01T00:00:00+05:30,2021-06-01,NEFT-001ONCF211525064-BARCLAYS GLOBAL SERVICE CENT,CREDIT,FT,116430.288,1678.8,RF208015609
M14440332,2021-06-03T00:00:00+05:30,2021-06-03,BIL/INFT/000128307390/Repay/                      ,CREDIT,OTHERS,200430.288,84000,RF209015610
M14450333,2021-06-03T00:00:00+05:30,2021-06-03,NEFT-SBIN321154884919-MR  ND KL AL-/ATTN//INB-0000003325266545,CREDIT,FT,260430.288,60000,RF210015611
M14460334,2021-06-03T00:00:00+05:30,2021-06-03,UPI/115413225139/pe/rajendraAL/State Bank Of ,CREDIT,UPI,263430.288,3000,RF211015612
M14470335,2021-06-04T00:00:00+05:30,2021-06-04,UPI/115500056402/pe/rajendraAL/State Bank Of ,CREDIT,UPI,317430.288,54000,RF212015613
M14480336,2021-06-07T00:00:00+05:30,2021-06-07,MMT/IMPS/115814725950/Kawade/Kawade/UTIB0001954   ,DEBIT,OTHERS,313830.288,3600,RF213015614
M14490337,2021-06-07T00:00:00+05:30,2021-06-07,NEFT-SBIN221158856858-SBI FUNDS MANAGEMENT PRIVATE LIMITE-/ATTN//INB-0000004000,CREDIT,FT,314999.28,1168.992,RF214015615
M14500338,2021-06-07T00:00:00+05:30,2021-06-07,UPI/115820218392/Earned for usin/goog-payment@ok/A,CREDIT,UPI,315001.08,1.8,RF215015616
M14510339,2021-06-08T00:00:00+05:30,2021-06-08,UPI/115921782990/UPI/paytm-1425436@p/Paytm Payment,DEBIT,UPI,314825.58,175.5,RF216015617
M14520340,2021-06-08T00:00:00+05:30,2021-06-08,UPI/115923226178/haircut/9405132413@okbi/Axis Bank,DEBIT,UPI,313755.18,1070.4,RF217015618
M14530341,2021-06-09T00:00:00+05:30,2021-06-09,UPI/116058114306/Furniture Payme/Q34544046@ybl/Axi,DEBIT,UPI,283755.18,30000,RF218015619
M14540342,2021-06-09T00:00:00+05:30,2021-06-09,UPI/116035255524/Newspaper Bill/siddharthgarud5/Ce,DEBIT,UPI,283551.18,204,RF219015620
M14550343,2021-06-10T00:00:00+05:30,2021-06-10,UPI/116148148484/Payment from Ph/9657739012@ybl/HD,DEBIT,UPI,265551.18,18000,RF220015621
M14560344,2021-06-15T00:00:00+05:30,2021-06-15,NEFT-SBIN421166059918-MR  ND KL AL-/ATTN//INB-0000003325266545,CREDIT,FT,325551.18,60000,RF221015622
M14570345,2021-06-15T00:00:00+05:30,2021-06-15,ACH/LICHOUSINGFINLTD/620500010790:25754988        ,DEBIT,FT,279475.98,46075.2,RF222015623
M14580346,2021-06-15T00:00:00+05:30,2021-06-15,BIL/INFT/000137742604/Shopping/                   ,DEBIT,OTHERS,267475.98,12000,RF223015624
M14590347,2021-06-15T00:00:00+05:30,2021-06-15,BIL/INFT/000137813686/Shopping/                   ,DEBIT,OTHERS,255475.98,12000,RF224015625
M14600348,2021-06-17T00:00:00+05:30,2021-06-17,UPI/116817321439/Blinds/dhans.artfulhom/Andhra Ban,DEBIT,UPI,249999.18,5476.8,RF225015626
M14610349,2021-06-17T00:00:00+05:30,2021-06-17,UPI/116809928960/Collect request/billdeskutility/Y,DEBIT,UPI,249421.38,577.8,RF226015627
M14620350,2021-06-17T00:00:00+05:30,2021-06-17,UPI/116818742496/tkt/preettravels07@/HDFC BANK LTD,DEBIT,UPI,248221.38,1200,RF227015628
M14630351,2021-06-18T00:00:00+05:30,2021-06-18,UPI/116935637810/Pendant/Bank Account XX/HDFC BANK,DEBIT,UPI,232039.38,16182,RF228015629
M14640352,2021-06-18T00:00:00+05:30,2021-06-18,UPI/116953383012/Furniture/Q34544046@ybl/Axis Bank,DEBIT,UPI,202039.38,30000,RF229015630
M14650353,2021-06-21T00:00:00+05:30,2021-06-21,UPI/117149604672/ten suites/paytmqr28100505/Paytm ,DEBIT,UPI,201829.38,210,RF230015631
M14660354,2021-06-21T00:00:00+05:30,2021-06-21,UPI/117255429645/payment on CRED/credclub@icici/IC,DEBIT,UPI,197497.98,4331.4,RF231015632
M14670355,2021-06-23T00:00:00+05:30,2021-06-23,UPI/117492026291/Payment from Ph/8830814313@ybl/Un,DEBIT,UPI,189097.98,8400,RF232015633
M14680356,2021-06-23T00:00:00+05:30,2021-06-23,BIL/INFT/000142944514/Sofa/                       ,DEBIT,OTHERS,159097.98,30000,RF233015634
M14690357,2021-06-24T00:00:00+05:30,2021-06-24,NEFT-001ONCF211755347-BARCLAYS GLOBAL SERVICE CENT,CREDIT,FT,257703.18,98605.2,RF234015635
M14700358,2021-06-24T00:00:00+05:30,2021-06-24,UPI/117593126407/Pay To FOOD VEN/bharatpe9071998/Y,DEBIT,UPI,257214.78,488.4,RF235015636
M14710359,2021-06-24T00:00:00+05:30,2021-06-24,UPI/117538447562/Collect request/billdesktatasky/Y,DEBIT,UPI,256914.78,300,RF236015637
M14720360,2021-06-25T00:00:00+05:30,2021-06-25,UPI/117606083340/Mumbai masala/paytmqr28100505/Pay,DEBIT,UPI,256756.98,157.8,RF237015638
M14730361,2021-06-28T00:00:00+05:30,2021-06-28,UPI/117708596839/Payment from Ph/9172441707@ybl/IC,CREDIT,UPI,259654.98,2898,RF238015639
M14740362,2021-06-28T00:00:00+05:30,2021-06-28,UPI/117825399585/Car Service/spandanshweta25/ICICI,DEBIT,UPI,252372.18,7282.8,RF239015640
M14750363,2021-06-28T00:00:00+05:30,2021-06-28,MMT/IMPS/117915251901/Bank Account Va/ACC VALIDA/H,CREDIT,OTHERS,252372.78,0.6,RF240015641
M14760364,2021-06-28T00:00:00+05:30,2021-06-28,RTGS-HDFCR52021062899796612-LICHOUSINGFINANCELTD-0,CREDIT,OTHERS,1242372.78,990000,RF241015642
M14770365,2021-06-28T00:00:00+05:30,2021-06-28,UPI/117936166300/Cushion/9850207070@okbi/Axis Bank,DEBIT,UPI,1239372.78,3000,RF242015643
M14780366,2021-06-29T00:00:00+05:30,2021-06-29,UPI/118040991969/Habib/9405132413@okbi/Axis Bank L,DEBIT,UPI,1236433.38,2939.4,RF243015644
M14790367,2021-06-29T00:00:00+05:30,2021-06-29,UPI/118077021163/Carpenter/Q34544046@ybl/Axis Bank,DEBIT,UPI,1206433.38,30000,RF244015645
M14800368,2021-06-29T00:00:00+05:30,2021-06-29,BIL/ONL/000147018497/cred.club/wwwcredclub1339    ,DEBIT,OTHERS,978271.38,228162,RF245015646
M14810369,2021-06-29T00:00:00+05:30,2021-06-29,BIL/ONL/000147021058/DreamplugT/HSU9WGKQJ57BPI    ,DEBIT,OTHERS,922767.78,55503.6,RF246015647
M14820370,2021-06-30T00:00:00+05:30,2021-06-30,238801500178:Int.Pd:30-03-2021 to 29-06-2021      ,CREDIT,OTHERS,924407.58,1639.8,RF247015648
M14830371,2021-06-30T00:00:00+05:30,2021-06-30,UPI/118152287319/Golu ayurveda/paytmqr28100505/Pay,DEBIT,UPI,923663.58,744,RF248015649
M14840372,2021-07-01T00:00:00+05:30,2021-07-01,BIL/NEFT/000148284701/Edu Loan Repaym/NAVRANG BH/S,DEBIT,OTHERS,911663.58,12000,RF249015650
M14850373,2021-07-03T00:00:00+05:30,2021-07-03,UPI/118490300831/Advance/parleenkaurjais/Union Ban,DEBIT,UPI,909203.58,2460,RF250015651
M14860374,2021-07-03T00:00:00+05:30,2021-07-03,UPI/118494303296/UPI/olamoney1.payu@/HDFC BANK LTD,DEBIT,UPI,908920.38,283.2,RF251015652
M14870375,2021-07-03T00:00:00+05:30,2021-07-03,UPI/118497338872/cushion 2/9850207070@okbi/Axis Ba,DEBIT,UPI,905920.38,3000,RF252015653
M14880376,2021-07-05T00:00:00+05:30,2021-07-05,UPI/118666607343/BhartiAirtelLim/airtelin.rzp@ax/A,DEBIT,UPI,905591.58,328.8,RF253015654
M14890377,2021-07-05T00:00:00+05:30,2021-07-05,UPI/118616637246/Advance/dfasate757@okax/Union Ban,DEBIT,UPI,902591.58,3000,RF254015655
M14900378,2021-07-05T00:00:00+05:30,2021-07-05,UPI/118622663797/penalty/suman71911@okic/ICICI Ban,DEBIT,UPI,902292.18,299.4,RF255015656
M14910379,2021-07-05T00:00:00+05:30,2021-07-05,UPI/118697768644/ur money/suman71911@okhd/HDFC BAN,CREDIT,UPI,902591.58,299.4,RF256015657
M14920380,2021-07-06T00:00:00+05:30,2021-07-06,BIL/NEFT/000153303222/Repay/OMPRAKASH /UTIB0001034,DEBIT,OTHERS,722591.58,180000,RF257015658
M14930381,2021-07-06T00:00:00+05:30,2021-07-06,UPI/118728268221/shoe/q93904276@ybl/State Bank Of ,DEBIT,UPI,721812.18,779.4,RF258015659
M14940382,2021-07-06T00:00:00+05:30,2021-07-06,UPI/118730133405/safa/q31746839@ybl/Union Bank of ,DEBIT,UPI,720672.18,1140,RF259015660
M14950383,2021-07-06T00:00:00+05:30,2021-07-06,UPI/118730650470/kurta/q73169578@ybl/Punjab Nation,DEBIT,UPI,720135.18,537,RF260015661
M14960384,2021-07-06T00:00:00+05:30,2021-07-06,UPI/118730697570/jacket/q73169578@ybl/Punjab Natio,DEBIT,UPI,719538.18,597,RF261015662
M14970385,2021-07-06T00:00:00+05:30,2021-07-06,UPI/118731892911/carpet/gpay-1117427776/Axis Bank ,DEBIT,UPI,716238.18,3300,RF262015663
M14980386,2021-07-06T00:00:00+05:30,2021-07-06,UPI/118742021784/Payment from Ph/9890911022@ybl/Ba,DEBIT,UPI,714177.78,2060.4,RF263015664
M14990387,2021-07-08T00:00:00+05:30,2021-07-08,UPI/118930422267/Payment from Ph/9657739012@ybl/HD,DEBIT,UPI,696177.78,18000,RF264015665
M15000388,2021-07-08T00:00:00+05:30,2021-07-08,UPI/118953118788/Advance/photorituals@ok/IDBI Bank,DEBIT,UPI,693177.78,3000,RF265015666
M15010389,2021-07-09T00:00:00+05:30,2021-07-09,BIL/NEFT/000155953443/Home/ND A/SBIN0003458 ,DEBIT,OTHERS,513177.78,180000,RF266015667
M15020390,2021-07-09T00:00:00+05:30,2021-07-09,UPI/119087368484/BhartiAirtelLim/bhartiairtel.rz/S,DEBIT,UPI,513027.18,150.6,RF267015668
M15030391,2021-07-09T00:00:00+05:30,2021-07-09,UPI/119011254268/Earned for usin/goog-payment@ok/A,CREDIT,UPI,513030.18,3,RF268015669
M15040392,2021-07-12T00:00:00+05:30,2021-07-12,UPI/119171965113/ecard/parleenkaurjais/Union Bank ,DEBIT,UPI,510570.18,2460,RF269015670
M15050393,2021-07-12T00:00:00+05:30,2021-07-12,UPI/119398770748/blazer/gpay-1117050610/Axis Bank ,DEBIT,UPI,508770.78,1799.4,RF270015671
M15060394,2021-07-12T00:00:00+05:30,2021-07-12,UPI/119398893460/pant/gpay-1117050610/Axis Bank Lt,DEBIT,UPI,508170.78,600,RF271015672
M15070395,2021-07-12T00:00:00+05:30,2021-07-12,UPI/119399157534/UPI/q31746839@ybl/Union Bank of I,DEBIT,UPI,507528.78,642,RF272015673
M15080396,2021-07-14T00:00:00+05:30,2021-07-14,UPI/119519988148/photographer 2/dfasate757@okax/Un,DEBIT,UPI,498528.78,9000,RF273015674
M15090397,2021-07-14T00:00:00+05:30,2021-07-14,NEFT-SBIN421195320456-SBI FUNDS MANAGEMENT PRIVATE LIMITE-/ATTN//INB-0000004000,CREDIT,FT,499676.982,1148.202,RF274015675
M15100398,2021-07-15T00:00:00+05:30,2021-07-15,ACH/LICHOUSINGFINLTD/620500010790:26572658        ,DEBIT,FT,453601.782,46075.2,RF275015676
M15110399,2021-07-19T00:00:00+05:30,2021-07-19,UPI/119948257484/Paying to Balle/ballebaazi.rzp@/I,DEBIT,UPI,453541.782,60,RF276015677
M15120400,2021-07-19T00:00:00+05:30,2021-07-19,UPI/119970820040/photographer/photorituals@ok/IDBI,DEBIT,UPI,435541.782,18000,RF277015678
M15130401,2021-07-23T00:00:00+05:30,2021-07-23,NEFT-001ONCF212049872-BARCLAYS GLOBAL SERVICE CENT,CREDIT,FT,534147.582,98605.8,RF278015679
M15140402,2021-07-23T00:00:00+05:30,2021-07-23,UPI/120428345726/Geysers/Q20198297@ybl/HDFC BANK LTD/YBL6c4783b3c8314908acd2f45,DEBIT,UPI,520287.582,13860,RF279015680
M15150403,2021-07-23T00:00:00+05:30,2021-07-23,UPI/120426601706/payment on CRED/credcc@yesbank/Yes Bank Ltd/eulcBhZEBHntdpqrRo,DEBIT,UPI,516463.278,3824.304,RF280015681
M15160404,2021-07-26T00:00:00+05:30,2021-07-26,UPI/120527000782/Sofa full/Q21124388@ybl/Yes Bank Ltd/YBL9550544b625a43158e09f4,DEBIT,UPI,501463.278,15000,RF281015682
M15170405,2021-07-26T00:00:00+05:30,2021-07-26,UPI/120540630307/Photographer pa/dfasate757@okax/Union Bank of I/ICI123700c6696,DEBIT,UPI,495463.278,6000,RF282015683
M15180406,2021-07-26T00:00:00+05:30,2021-07-26,UPI/120647238518/UPI/add-money@paytm/Paytm Payment,DEBIT,UPI,494263.278,1200,RF283015684
M15190407,2021-07-26T00:00:00+05:30,2021-07-26,BIL/ONL/000167334348/cred.club/wwwcredclub1364/cc ,DEBIT,OTHERS,445126.278,49137,RF284015685
M15200408,2021-07-26T00:00:00+05:30,2021-07-26,UPI/120687723353/payment on CRED/credclub@icici/IC,DEBIT,UPI,436804.578,8321.7,RF285015686
M15210409,2021-07-27T00:00:00+05:30,2021-07-27,UPI/120868361136/skin doc/skinethics.9938/HDFC BANK LTD/ICI2de23795b7d748188231,DEBIT,UPI,436504.578,300,RF286015687
M15220410,2021-07-27T00:00:00+05:30,2021-07-27,UPI/120886784804/Skin meds/gpay-1116488878/Axis Bank Ltd./YBL45e5ad3aac724452bf,DEBIT,UPI,435337.578,1167,RF287015688
M15230411,2021-07-28T00:00:00+05:30,2021-07-28,UPI/120942484258/Payment from Ph/BILLDESKTATASKY/Yes Bank Ltd/YBL8a2ad039db0b47,DEBIT,UPI,435037.578,300,RF288015689
M15240412,2021-07-29T00:00:00+05:30,2021-07-29,UPI/121055926715/1mg Technologie/1mgtechnologies/Paytm Payments /YBLa964ea2841e,DEBIT,UPI,433736.778,1300.8,RF289015690
M15250413,2021-07-29T00:00:00+05:30,2021-07-29,UPI/121089528864/1mg Technologie/1mgtechnologies/Paytm Payments /ICI03f17bfe270,DEBIT,UPI,432987.378,749.4,RF290015691
M15260414,2021-07-29T00:00:00+05:30,2021-07-29,UPI/121026576921/1mg Technologie/1mgtechnologies/Paytm Payments /YBL9e5e07ca059,DEBIT,UPI,432549.978,437.4,RF291015692
M15270415,2021-07-31T00:00:00+05:30,2021-07-31,UPI/121255381153/Full payment/Q34544046@ybl/Axis Bank Ltd./YBLbd7bff187abb49ba9,DEBIT,UPI,420549.978,12000,RF292015693
M15280416,2021-07-31T00:00:00+05:30,2021-07-31,MMT/IMPS/121215899581/Repay/Vivek Bhag/YESB0ADB091,DEBIT,OTHERS,360549.978,60000,RF293015694
M15290417,2021-07-31T00:00:00+05:30,2021-07-31,MMT/IMPS/121215899581/Repay/Vivek Bhag/YESB0ADB091,CREDIT,OTHERS,420549.978,60000,RF294015695
M15300418,2021-08-02T00:00:00+05:30,2021-08-02,BIL/NEFT/000172376732/Edu Loan Repaym/NAVRANG BH/S,DEBIT,OTHERS,408549.978,12000,RF295015696
M15310419,2021-08-02T00:00:00+05:30,2021-08-02,UPI/121328824454/plants/rakeshrosenurse/Central Bank Of/ICI9bb08ff28ba54af9b2e3,DEBIT,UPI,406455.978,2094,RF296015697
M15320420,2021-08-02T00:00:00+05:30,2021-08-02,BIL/NEFT/000173836105/MaleBooking/Clayo Tech/RATN0,DEBIT,OTHERS,381481.518,24974.46,RF297015698
M15330421,2021-08-03T00:00:00+05:30,2021-08-03,UPI/121574414950/HitanshChocs/bigbasket1@payt/Paytm Payments /YBL73c3b2d798d448,DEBIT,UPI,381009.834,471.684,RF298015699
M15340422,2021-08-03T00:00:00+05:30,2021-08-03,UPI/121562578720/DP hafta/suman71911@okic/ICICI Bank/ICIf65a5d05de56496b9474ff5,DEBIT,UPI,380709.834,300,RF299015700
M15350423,2021-08-04T00:00:00+05:30,2021-08-04,UPI/121610246215/Covid test/Q92688107@ybl/Yes Bank Ltd/YBL9f1746b7a7064a9883b8d,DEBIT,UPI,380349.834,360,RF300015701
M15360424,2021-08-04T00:00:00+05:30,2021-08-04,UPI/121612695161/PhonePe Reversa/phonepemerchant/Yes Bank Ltd/YESBC8B7194637B55,CREDIT,UPI,380709.834,360,RF301015702
M15370425,2021-08-06T00:00:00+05:30,2021-08-06,UPI/121893085836/UPI/olamoney1.rzp@a/Axis Bank Ltd./ICI2ff36a9bebaa4a0db5dfddbb,DEBIT,UPI,380423.034,286.8,RF302015703
M15380426,2021-08-06T00:00:00+05:30,2021-08-06,UPI/121845360647/Payment for net/NETMEDS@ybl/Yes Bank Ltd/YBLa2c2053c01164bb991,DEBIT,UPI,379860.894,562.14,RF303015704
M15390427,2021-08-07T00:00:00+05:30,2021-08-07,UPI/121938274112/Payment for PE1/PHARMEASYV2@ybl/Yes Bank Ltd/YBLa632f8a19a7c47,DEBIT,UPI,378865.86,995.034,RF304015705
M15400428,2021-08-07T00:00:00+05:30,2021-08-07,BIL/INFT/000178636142/Deepa/                      ,DEBIT,OTHERS,366865.86,12000,RF305015706
M15410429,2021-08-07T00:00:00+05:30,2021-08-07,MMT/IMPS/121914992618/ForexDiff/UTIB0000073       ,DEBIT,OTHERS,366756.66,109.2,RF306015707
M15420430,2021-08-07T00:00:00+05:30,2021-08-07,UPI/121920235837/Upi Transaction/moneycontrol.pa/INDUSIND BANK/INDBC890C2394B32,DEBIT,UPI,366537.66,219,RF307015708
M15430431,2021-08-07T00:00:00+05:30,2021-08-07,UPI/121920646024/Earned for usin/goog-payment@ok/Axis Bank Ltd./AXIf462badd7a0b,CREDIT,UPI,366540.66,3,RF308015709
M15440432,2021-08-09T00:00:00+05:30,2021-08-09,UPI/122134457875/covid tests/q68139228@ybl/Yes Bank Ltd/ICIc394868b3e444aa0891d,DEBIT,UPI,365820.66,720,RF309015710
M15450433,2021-08-10T00:00:00+05:30,2021-08-10,UPI/122255955762/UPI/dominospizzaonl/Paytm Payment,DEBIT,UPI,365512.86,307.8,RF310015711
M15460434,2021-08-11T00:00:00+05:30,2021-08-11,UPI/122363938219/Fanta/paytmqr28100505/Paytm Payments /YBLfe52cd7da24a4411b6304,DEBIT,UPI,365488.86,24,RF311015712
M15470435,2021-08-11T00:00:00+05:30,2021-08-11,UPI/122307627573/ICICI Prudentia/iciciprulifeins/Axis Bank Ltd./AXIba0556bf33a6,DEBIT,UPI,357276.06,8212.8,RF312015713
M15480436,2021-08-16T00:00:00+05:30,2021-08-16,ACH/LICHOUSINGFINLTD/620500010790:27436249        ,DEBIT,FT,311200.86,46075.2,RF313015714
M15490437,2021-08-16T00:00:00+05:30,2021-08-16,BIL/NEFT/000185689078/Soc Maintenance/NAVRANG BH/S,DEBIT,OTHERS,298600.86,12600,RF314015715
M15500438,2021-08-16T00:00:00+05:30,2021-08-16,UPI/122831958346/full pay/9850207070@okbi/Axis Bank Ltd./ICI910078d99bec41a5960,DEBIT,UPI,297400.86,1200,RF315015716
M15510439,2021-08-18T00:00:00+05:30,2021-08-18,UPI/123058511469/tkt/preettravels07@/State Bank Of I/ICIeb5062e4e86a495ca864e52,DEBIT,UPI,295840.86,1560,RF316015717
M15520440,2021-08-20T00:00:00+05:30,2021-08-20,UPI/123274563898/July Bill/dineshchandraga/State Bank Of I/ICI6265a243eea844ce9,DEBIT,UPI,295684.86,156,RF317015718
M15530441,2021-08-23T00:00:00+05:30,2021-08-23,UPI/123420496996/Payment from Ph/9657739012@ybl/HDFC BANK LTD/YBL017145daa2c442,DEBIT,UPI,277684.86,18000,RF318015719
M15540442,2021-08-23T00:00:00+05:30,2021-08-23,UPI/123455940325/Icecream/upiswiggy@icici/ICICI Bank/YBL23a535d363644f52a423d5c,DEBIT,UPI,277449.06,235.8,RF319015720
M15550443,2021-08-24T00:00:00+05:30,2021-08-24,UPI/123618955101/bread/paytmqr28100505/Paytm Payments /ICI41ada3323ad44038bd2d0,DEBIT,UPI,277431.06,18,RF320015721
M15560444,2021-08-24T00:00:00+05:30,2021-08-24,UPI/123619846623/haircut/paytmqr28100505/Paytm Payments /ICIeca2ced33c8742c180c,DEBIT,UPI,277359.06,72,RF321015722
M15570445,2021-08-24T00:00:00+05:30,2021-08-24,NEFT-001ONCF21236A1Q1-BARCLAYS GLOBAL SERVICE CENT,CREDIT,FT,367330.86,89971.8,RF322015723
M15580446,2021-08-26T00:00:00+05:30,2021-08-26,UPI/123842353392/tkt/preettravels07@/State Bank Of I/ICIb4e1ab8f990d4b3b8f7addd,DEBIT,UPI,367150.86,180,RF323015724
M15590447,2021-08-30T00:00:00+05:30,2021-08-30,UPI/124020247145/YOUBROADBAND/billdesk@hdfcba/HDFC BANK LTD/HDF3D969C7558224DFE,DEBIT,UPI,365532.66,1618.2,RF324015725
M15600448,2021-08-30T00:00:00+05:30,2021-08-30,UPI/124033299364/Swiggy Order Id/swiggyupi@axisb/Axis Bank Ltd./AXISSDKV3b16f6a,DEBIT,UPI,365419.26,113.4,RF325015726
M15610449,2021-08-30T00:00:00+05:30,2021-08-30,UPI/124299755899/cab/gpay-1118117844/Axis Bank Ltd./ICI6f61c50c26f7475795307a97,DEBIT,UPI,364369.86,1049.4,RF326015727
M15620450,2021-09-01T00:00:00+05:30,2021-09-01,BIL/NEFT/000196307937/Edu Loan Repaym/NAVRANG BH/S,DEBIT,OTHERS,352369.86,12000,RF327015728
M15630451,2021-09-01T00:00:00+05:30,2021-09-01,BIL/000197157250/-100000544020/WWWCREDCLUB1389    ,DEBIT,OTHERS,230614.86,121755,RF328015729
M15640452,2021-09-01T00:00:00+05:30,2021-09-01,UPI/124486288226/payment on CRED/credcc@yesbank/Yes Bank Ltd/eulixkTTCYoiFrjXrm,DEBIT,UPI,226998.06,3616.8,RF329015730
M15650453,2021-09-02T00:00:00+05:30,2021-09-02,BIL/ONL/000197831744/One97 Comm/202109022136474/Mu,DEBIT,OTHERS,226908.66,89.4,RF330015731
M15660454,2021-09-02T00:00:00+05:30,2021-09-02,NEFT-SBIN121245251135-SBI FUNDS MANAGEMENT PRIVATE LIMITE-/ATTN//INB-0000004000,CREDIT,FT,227430.804,522.144,RF331015732
M15670455,2021-09-07T00:00:00+05:30,2021-09-07,UPI/125012046593/coffee/q67702947@ybl/Yes Bank Ltd/ICIe49b4677588b426c876dddd00,DEBIT,UPI,227147.004,283.8,RF332015733
M15680456,2021-09-09T00:00:00+05:30,2021-09-09,BIL/ONL/000204637943/Zomato Med/zoma01210903935/Pi,DEBIT,OTHERS,226674.804,472.2,RF333015734
M15690457,2021-09-09T00:00:00+05:30,2021-09-09,UPI/125238691396/pan/paytmqr28100505/Paytm Payments /ICI4fc9b29f6985430c98c2641,DEBIT,UPI,226620.804,54,RF334015735
M15700458,2021-09-09T00:00:00+05:30,2021-09-09,UPI/125238745581/pan/gpay-1118716581/Axis Bank Ltd./ICI2714eb5cb0ac47de88e2173f,DEBIT,UPI,226584.804,36,RF335015736
M15710459,2021-09-13T00:00:00+05:30,2021-09-13,UPI/125459897009/Photographer Fu/dfasate757@okax/Union Bank of I/ICIcf9be685ff3,DEBIT,UPI,223584.804,3000,RF336015737
M15720460,2021-09-13T00:00:00+05:30,2021-09-13,UPI/125630075116/Upi Transaction/milaap.payu@hdf/HDFC BANK LTD/HDF4AA6C82C3A824,DEBIT,UPI,222924.804,660,RF337015738
M15730461,2021-09-14T00:00:00+05:30,2021-09-14,UPI/125706294499/Peter cafe/q67702947@ybl/Yes Bank Ltd/ICI18cf9635bc794d9faff2d,DEBIT,UPI,222447.804,477,RF338015739
M15740462,2021-09-15T00:00:00+05:30,2021-09-15,ACH/LICHOUSINGFINLTD/620500010790:28299876        ,DEBIT,FT,176372.604,46075.2,RF339015740
M15750463,2021-09-18T00:00:00+05:30,2021-09-18,VPS/JUPITER HOS/202109180902/126103016872/PUNE    ,DEBIT,OTHERS,175904.604,468,RF340015741
M15760464,2021-09-20T00:00:00+05:30,2021-09-20,UPI/126205875841/NA/gpay-1119818351/Axis Bank Ltd./PTMca2d22eecc40412b8b368b31d,DEBIT,UPI,175869.204,35.4,RF341015742
M15770465,2021-09-20T00:00:00+05:30,2021-09-20,UPI/126271023847/Pastry/atul.lavate24@o/ICICI Bank/ICI86c9a477f5d94a0b832f68794,DEBIT,UPI,175761.204,108,RF342015743
M15780466,2021-09-22T00:00:00+05:30,2021-09-22,UPI/126550440015/Payment from Ph/9657739012@ybl/HDFC BANK LTD/YBLde1d1f1db53547,DEBIT,UPI,157761.204,18000,RF343015744
M15790467,2021-09-23T00:00:00+05:30,2021-09-23,UPI/126612894669/coconut/q400565955@ybl/Axis Bank Ltd./ICIc6ab8687443a4c859e1ff,DEBIT,UPI,157701.204,60,RF344015745
M15800468,2021-09-24T00:00:00+05:30,2021-09-24,UPI/126716124815/Bandaids/paytmqr28100505/Paytm Payments /YBL4213e56862944335b3,DEBIT,UPI,157686.204,15,RF345015746
M15810469,2021-09-24T00:00:00+05:30,2021-09-24,NEFT-001ONCF21267A5F1-BARCLAYS GLOBAL SERVICE CENT,CREDIT,FT,250538.004,92851.8,RF346015747
M15820470,2021-09-24T00:00:00+05:30,2021-09-24,UPI/126791337082/Panipuri/paytmqr28100505/Paytm Payments /YBLbccee94727d84605ab,DEBIT,UPI,250352.004,186,RF347015748
M15830471,2021-09-27T00:00:00+05:30,2021-09-27,UPI/126840054783/Aug Bill/dineshchandraga/State Bank Of I/ICI9fec1624755e4934b6,DEBIT,UPI,250127.004,225,RF348015749
M15840472,2021-09-27T00:00:00+05:30,2021-09-27,UPI/126953318619/books/suman71911@okic/ICICI Bank/ICIe583f824d1c2474dab45d6f46f,DEBIT,UPI,249827.004,300,RF349015750
M15850473,2021-09-27T00:00:00+05:30,2021-09-27,UPI/126939688293/payment on CRED/credclub@icici/IC,DEBIT,UPI,249769.512,57.492,RF350015751
M15860474,2021-09-28T00:00:00+05:30,2021-09-28,UPI/127109735671/BhartiAirtelLim/airtelin.rzp@ax/Axis Bank Ltd./YBL09866b0748c6,DEBIT,UPI,249440.712,328.8,RF351015752
M15870475,2021-09-29T00:00:00+05:30,2021-09-29,UPI/127275818445/payment on CRED/credcc@yesbank/Yes Bank Ltd/eul71tN4cCcgvsnM7R,DEBIT,UPI,229980.312,19460.4,RF352015753
M15880476,2021-09-30T00:00:00+05:30,2021-09-30,238801500178:Int.Pd:30-06-2021 to 29-09-2021      ,CREDIT,OTHERS,232871.712,2891.4,RF353015754
M15890477,2021-09-30T00:00:00+05:30,2021-09-30,BIL/ONL/000219415711/Zomato Med/zoma01210903951/Bu,DEBIT,OTHERS,232424.982,446.73,RF354015755
M15900478,2021-09-30T00:00:00+05:30,2021-09-30,MMT/IMPS/127319486884/Edu Loan EMI/NAVRANG BH/SBIN,DEBIT,OTHERS,220424.982,12000,RF355015756
M15910479,2021-09-30T00:00:00+05:30,2021-09-30,UPI/127317979657/payment on CRED/credclub@icici/IC,DEBIT,UPI,219645.726,779.256,RF356015757
M15920480,2021-10-01T00:00:00+05:30,2021-10-01,UPI/127318657505/UPI/paytm-8736773@p/Paytm Payments /ICIbd0419271dc64698af8d3fc,DEBIT,UPI,219262.866,382.86,RF357015758
M15930481,2021-10-01T00:00:00+05:30,2021-10-01,UPI/127420420996/Upi Transaction/dtdc.payu@icici/ICICI Bank/ICIca36b8ffd63340f6,DEBIT,UPI,218824.866,438,RF358015759
M15940482,2021-10-01T00:00:00+05:30,2021-10-01,UPI/127420773954/Upi Transaction/dtdc.payu@icici/ICICI Bank/ICI949f33ee691948d8,DEBIT,UPI,218386.866,438,RF359015760
M15950483,2021-10-01T00:00:00+05:30,2021-10-01,UPI/127433044608/paan/paytmqr28100505/Paytm Payments /ICId9a68fc38e0547ee86882f,DEBIT,UPI,218329.866,57,RF360015761
M15960484,2021-10-04T00:00:00+05:30,2021-10-04,UPI/127542148881/UPI/ekta9n@okicici/ICICI Bank/ICI963f5e3037b546dbba4224ec3aecb,CREDIT,UPI,223594.866,5265,RF361015762
M15970485,2021-10-04T00:00:00+05:30,2021-10-04,UPI/127503903128/Food/Q97833754@ybl/Yes Bank Ltd/YBLa693a79380514487ae0af914bdb,DEBIT,UPI,223444.866,150,RF362015763
M15980486,2021-10-04T00:00:00+05:30,2021-10-04,UPI/127565796585/Paying to Balle/ballebaazi@payt/Paytm Payments /YBLddde0d06798,DEBIT,UPI,223384.866,60,RF363015764
M15990487,2021-10-04T00:00:00+05:30,2021-10-04,UPI/127769753985/OidPZT211004121/paytm-56505013@/Paytm Payments /PTM42d0c36c900,DEBIT,UPI,222668.466,716.4,RF364015765
M16000488,2021-10-04T00:00:00+05:30,2021-10-04,UPI/127768508764/mamaearth/ekta9n@okicici/ICICI Bank/ICIb3e30a3543304119b566f22,CREDIT,UPI,223325.466,657,RF365015766
M16010489,2021-10-04T00:00:00+05:30,2021-10-04,UPI/127718147535/Payment from Ph/9766560263@ybl/ICICI Bank/YBL1e9f73927e1c44469,DEBIT,UPI,222125.466,1200,RF366015767
M16020490,2021-10-04T00:00:00+05:30,2021-10-04,UPI/127752115741/Payment from Ph/9620986689@ybl/ICICI Bank/YBL765afaee6f4c430fb,DEBIT,UPI,221525.466,600,RF367015768
M16030491,2021-10-04T00:00:00+05:30,2021-10-04,UPI/127773089547/Final Pay/photorituals@ok/IDBI Bank Limit/ICI959fbd8e8e6648d49,DEBIT,UPI,212525.466,9000,RF368015769
M16040492,2021-10-04T00:00:00+05:30,2021-10-04,UPI/127776805898/Refund for 1403/dtdc.payu@icici/ICICI Bank/ICI6be1bf3466c74967,CREDIT,UPI,212963.466,438,RF369015770
M16050493,2021-10-06T00:00:00+05:30,2021-10-06,UPI/127928519406/Meds/gpay-1118037476/Axis Bank Ltd./YBL8587d02c69ab44ecb50c2ef,DEBIT,UPI,212888.466,75,RF370015771
M16060494,2021-10-06T00:00:00+05:30,2021-10-06,UPI/127957997795/Coconut/Q400565955@ybl/Axis Bank Ltd./YBL0a5c153b8c004c088c6fa,DEBIT,UPI,212828.466,60,RF371015772
M16070495,2021-10-06T00:00:00+05:30,2021-10-06,UPI/127921780846/Meds/paytmqr28100505/Paytm Payments /YBLd397ec1df99b4d86984df7,DEBIT,UPI,212703.066,125.4,RF372015773
M16080496,2021-10-06T00:00:00+05:30,2021-10-06,UPI/127933895181/Pan shop/Q151604481@ybl/Yes Bank Ltd/YBL908d166141ef4e528520ad,DEBIT,UPI,212698.866,4.2,RF373015774
M16090497,2021-10-07T00:00:00+05:30,2021-10-07,BIL/INFT/000226754246/Share Transfer/             ,DEBIT,OTHERS,146548.866,66150,RF374015775
M16100498,2021-10-07T00:00:00+05:30,2021-10-07,BIL/INFT/000226757043/Share Transfer/             ,DEBIT,OTHERS,80398.866,66150,RF375015776
M16110499,2021-10-07T00:00:00+05:30,2021-10-07,BIL/INFT/000226758955/Share Transfer/             ,DEBIT,OTHERS,14248.866,66150,RF376015777
M16120500,2021-10-07T00:00:00+05:30,2021-10-07,UPI/128061936546/Payment from Ph/9657739012@ybl/ICICI Bank/YBLd2e70621ef424f1a8,CREDIT,UPI,62398.866,48150,RF377015778
M16130501,2021-10-07T00:00:00+05:30,2021-10-07,BIL/INFT/000226924511/testTxn/                    ,CREDIT,OTHERS,62399.466,0.6,RF378015779
M16140502,2021-10-07T00:00:00+05:30,2021-10-07,BIL/INFT/000227010450/                            ,CREDIT,OTHERS,128549.466,66150,RF379015780
M16150503,2021-10-11T00:00:00+05:30,2021-10-11,BIL/INFT/000227946938/OneRsUdhaar/                ,CREDIT,OTHERS,194700.066,66150.6,RF380015781
M16160504,2021-10-11T00:00:00+05:30,2021-10-11,UPI/128364681904/newspaper bill/dineshchandraga/State Bank Of I/ICIa2b934f31790,DEBIT,UPI,194484.066,216,RF381015782
M16170505,2021-10-13T00:00:00+05:30,2021-10-13,BIL/NEFT/000231741435/Bhagat Repay/ND A/SBIN,DEBIT,OTHERS,164484.066,30000,RF382015783
M16180506,2021-10-15T00:00:00+05:30,2021-10-15,ACH/LICHOUSINGFINLTD/620500010790:29211700        ,DEBIT,FT,118408.866,46075.2,RF383015784
M16190507,2021-10-22T00:00:00+05:30,2021-10-22,UPI/129521229265/ola/olamoney1.rzp@a/Axis Bank Ltd./ICI19ee2037ab3743998edf7a26,DEBIT,UPI,118223.466,185.4,RF384015785
M16200508,2021-10-22T00:00:00+05:30,2021-10-22,UPI/129590665870/payment on CRED/credcc@yesbank/Yes Bank Ltd/eul4xMU33rS9NYzFmh,DEBIT,UPI,111447.666,6775.8,RF385015786
M16210509,2021-10-22T00:00:00+05:30,2021-10-22,NEFT-001ONCF21295A09C-BARCLAYS GLOBAL SERVICE CENT,CREDIT,FT,221124.666,109677,RF386015787
M16220510,2021-10-22T00:00:00+05:30,2021-10-22,UPI/129530802274/Haircut/9405132413@okbi/Axis Bank Ltd./YBL07f8eb4f6af74a7e8acb,DEBIT,UPI,220974.666,150,RF387015788
M16230511,2021-10-25T00:00:00+05:30,2021-10-25,UPI/129808617964/Payment from Ph/8408835444@ybl/Axis Bank Ltd./YBLd6ee3f6c8be64,DEBIT,UPI,218742.666,2232,RF388015789
M16240512,2021-10-26T00:00:00+05:30,2021-10-26,UPI/129976791344/Coconut/gpay-1118361359/Axis Bank Ltd./YBLcca2a79a266b480c87bb,DEBIT,UPI,218682.666,60,RF389015790
M16250513,2021-10-26T00:00:00+05:30,2021-10-26,BIL/ONL/000240718934/Transport /6406983987825/RTO ,DEBIT,OTHERS,140961.186,77721.48,RF390015791
M16260514,2021-10-28T00:00:00+05:30,2021-10-28,UPI/130136244095/Juice/paytmqr28100505/Paytm Payments /YBL2319b9298ab04c8abc0ab,DEBIT,UPI,140925.186,36,RF391015792
M16270515,2021-10-29T00:00:00+05:30,2021-10-29,UPI/130205163045/Kia service/Q57072441@ybl/Yes Bank Ltd/YBLaa178908c4354604b1c8,DEBIT,UPI,140889.186,36,RF392015793
M16280516,2021-10-30T00:00:00+05:30,2021-10-30,UPI/130371266038/Oid202110302034/paytm-47839457@/Paytm Payments /PTM790f53a0a42,DEBIT,UPI,140817.186,72,RF393015794
M16290517,2021-10-30T00:00:00+05:30,2021-10-30,UPI/130382992225/Paying to Balle/ballebaazi@payt/Paytm Payments /YBL72ee1b9e54c,DEBIT,UPI,140757.186,60,RF394015795
M16300518,2021-11-01T00:00:00+05:30,2021-11-01,BIL/NEFT/000245326952/Loan Repay/NAVRANG BH/SBIN00,DEBIT,OTHERS,128757.186,12000,RF395015796
M16310519,2021-11-01T00:00:00+05:30,2021-11-01,UPI/130515990326/payment on CRED/credcc@yesbank/Yes Bank Ltd/euldaCfzNqtmkckeF3,DEBIT,UPI,103797.786,24959.4,RF396015797
M16320520,2021-11-01T00:00:00+05:30,2021-11-01,UPI/130566973258/payment on CRED/credclub@icici/IC,DEBIT,UPI,103004.79,792.996,RF397015798
M16330521,2021-11-01T00:00:00+05:30,2021-11-01,UPI/130568719145/UPI/ekta9n@okicici/ICICI Bank/ICI2392c5870c3a40daa2ef102e1f2e9,CREDIT,UPI,148004.79,45000,RF398015799
M16340522,2021-11-01T00:00:00+05:30,2021-11-01,NEFT-N305211697420397-AKSHAY MAHENDRA AL-OK-5,CREDIT,FT,259004.79,111000,RF399015800
M16350523,2021-11-01T00:00:00+05:30,2021-11-01,UPI/130522352454/UPI/ALakshay16/HDFC BANK LTD/HDF68a7c791777c448584ba742a9,CREDIT,UPI,268004.79,9000,RF400015801
M16360524,2021-11-03T00:00:00+05:30,2021-11-03,UPI/130706432629/Pay To SUNRISE/bharatpe.903037/ICICI Bank/ICI672fe7b378e749638,DEBIT,UPI,267497.79,507,RF401015802
M16370525,2021-11-05T00:00:00+05:30,2021-11-05,MMT/IMPS/130912752020/Gattu Fees/SVKM NMIMS/KKBK00,DEBIT,OTHERS,62597.79,204900,RF402015803
M16380526,2021-11-05T00:00:00+05:30,2021-11-05,UPI/130975536688/BhartiAirtelLim/bhartiairtel.rz/State Bank Of I/YBL7c2b84f71d8,DEBIT,UPI,62538.99,58.8,RF403015804
M16390527,2021-11-08T00:00:00+05:30,2021-11-08,UPI/131279076877/TREK THE HIMALA/razorpay@icici/ICICI Bank/ICIaeec788072cb4e3fb,DEBIT,UPI,44016.99,18522,RF404015805
M16400528,2021-11-09T00:00:00+05:30,2021-11-09,MMT/IMPS/131320986292/MOBLT0911201740/NAVRANG KE/S,CREDIT,OTHERS,47016.99,3000,RF405015806
M16410529,2021-11-09T00:00:00+05:30,2021-11-09,NEFT-0811OP1006891108-AAKASH ND AL--881,CREDIT,FT,51816.99,4800,RF406015807
M16420530,2021-11-09T00:00:00+05:30,2021-11-09,UPI/131323436306/dayara bugyal t/chetan15994@oks/State Bank Of I/SBI73e3e4ddfa1,CREDIT,UPI,57990.99,6174,RF407015808
M16430531,2021-11-10T00:00:00+05:30,2021-11-10,UPI/131416188216/2way flight tic/chetan15994@oks/State Bank Of I/SBI468c71af370,CREDIT,UPI,63810.99,5820,RF408015809
M16440532,2021-11-12T00:00:00+05:30,2021-11-12,UPI/131609008934/Oid100003024749/paytm-irctcapp@/Paytm Payments /PTM20211112227,DEBIT,UPI,61744.83,2066.16,RF409015810
M16450533,2021-11-12T00:00:00+05:30,2021-11-12,UPI/131609238815/Oid100003024894/paytm-irctcapp@/Paytm Payments /PTM20211112228,DEBIT,UPI,59660.67,2084.16,RF410015811
M16460534,2021-11-15T00:00:00+05:30,2021-11-15,UPI/131790041261/collect/paytm-irctcapp@/Paytm Payments /PTMa7f219a6c6634f42ab5,CREDIT,UPI,61370.67,1710,RF411015812
M16470535,2021-11-15T00:00:00+05:30,2021-11-15,ACH/LICHOUSINGFINLTD/620500010790:30119913        ,DEBIT,FT,15295.47,46075.2,RF412015813
M16480536,2021-11-15T00:00:00+05:30,2021-11-15,UPI/131975620598/Payment from Ph/9620986689@ybl/ICICI Bank/YBL9ad291c24ab84f3db,CREDIT,UPI,29455.47,14160,RF413015814
M16490537,2021-11-15T00:00:00+05:30,2021-11-15,UPI/131946540917/Payment from Ph/9620986689@ybl/ICICI Bank/YBL44fb0e4c9da64c51b,CREDIT,UPI,38455.47,9000,RF414015815
M16500538,2021-11-16T00:00:00+05:30,2021-11-16,UPI/132066120187/Payment from Ph/9657739012@ybl/HDFC BANK LTD/YBL6f460b1d883c45,DEBIT,UPI,20455.47,18000,RF415015816
M16510539,2021-11-17T00:00:00+05:30,2021-11-17,UPI/132100552722/trip/darshanAL7/Axis Bank Ltd./ICI7fe658f0b22e4d17a9b52fb,DEBIT,UPI,18055.47,2400,RF416015817
M16520540,2021-11-19T00:00:00+05:30,2021-11-19,UPI/132312449294/Verified Mercha/BHARATPE.905143/Federal Bank/YBLd4810a8c445545,DEBIT,UPI,17995.47,60,RF417015818
M16530541,2021-11-19T00:00:00+05:30,2021-11-19,UPI/132337607993/Payment from Ph/9620986689@ybl/ICICI Bank/YBLff24c398c22d49e1b,CREDIT,UPI,21096.27,3100.8,RF418015819
M16540542,2021-11-20T00:00:00+05:30,2021-11-20,UPI/132426578029/Misal/paytmqr28100505/Paytm Payments /YBLe2dcef89c166478aa6521,DEBIT,UPI,20772.27,324,RF419015820
M16550543,2021-11-20T00:00:00+05:30,2021-11-20,UPI/132440893058/skinDoc/skinethics.9938/HDFC BANK LTD/ICI9fc2e9f58da14b6a87319,DEBIT,UPI,20472.27,300,RF420015821
M16560544,2021-11-20T00:00:00+05:30,2021-11-20,UPI/132470261280/Oid100003045633/paytm-irctcapp@/Paytm Payments /PTM20211120231,DEBIT,UPI,19594.11,878.16,RF421015822
M16570545,2021-11-20T00:00:00+05:30,2021-11-20,UPI/132421246830/UberRide/uberrides@hdfcb/HDFC BANK LTD/YBL0c8991443b49439db28a,DEBIT,UPI,19510.11,84,RF422015823
M16580546,2021-11-22T00:00:00+05:30,2021-11-22,UPI/132572289142/Breakfast/9921753275@icic/ICICI Bank/YBLf85bbce51ccf4bf2ad7750,DEBIT,UPI,19459.11,51,RF423015824
M16590547,2021-11-22T00:00:00+05:30,2021-11-22,UPI/132555266493/Swabhimani Groc/paytmqr28100505/Paytm Payments /YBL9035c4cd18b,DEBIT,UPI,19243.11,216,RF424015825
M16600548,2021-11-22T00:00:00+05:30,2021-11-22,UPI/132634072669/ETMONEY/etmoney.razorpa/HDFC BANK LTD/YBLa70a418d56024b3ca5334,DEBIT,UPI,18643.11,600,RF425015826
M16610549,2021-11-22T00:00:00+05:30,2021-11-22,NEFT-SBIN521326725035-SBI FUNDS MANAGEMENT PRIVATE LIMITE-/ATTN//INB-0000004000,CREDIT,FT,18747.606,104.496,RF426015827
M16620550,2021-11-23T00:00:00+05:30,2021-11-23,UPI/132726391383/DecathlonSports/decathlon.rzp@s/State Bank Of I/YBL77f4e111b61,DEBIT,UPI,17155.806,1591.8,RF427015828
M16630551,2021-11-23T00:00:00+05:30,2021-11-23,UPI/132788628643/pizza/dominospizzaonl/Paytm Payme,DEBIT,UPI,16810.206,345.6,RF428015829
M16640552,2021-11-24T00:00:00+05:30,2021-11-24,NEFT-001ONCF213285469-BARCLAYS GLOBAL SERVICE CENT,CREDIT,FT,126487.206,109677,RF429015830
M16650553,2021-11-26T00:00:00+05:30,2021-11-26,UPI/133021496160/ETMONEY/etmoney.rzp@axi/Axis Bank Ltd./ICI125c7a0e0a5942b0a2c3,DEBIT,UPI,125887.206,600,RF430015831
M16660554,2021-11-29T00:00:00+05:30,2021-11-29,NEFT-SBIN421331406852-MR  ND KL AL-/ATTN//INB-0000003325266545,CREDIT,FT,137887.206,12000,RF431015832
M16670555,2021-11-29T00:00:00+05:30,2021-11-29,BIL/NEFT/000265384789/Maintenance/Aditis Rib/SBIN0,DEBIT,OTHERS,127387.206,10500,RF432015833
M16680556,2021-11-29T00:00:00+05:30,2021-11-29,UPI/133137267601/food/dominospizzaonl/Paytm Paymen,DEBIT,UPI,126927.606,459.6,RF433015834
M16690557,2021-11-29T00:00:00+05:30,2021-11-29,BIL/NEFT/000266129620/Interest/Kawade    /UTIB0001,DEBIT,OTHERS,124527.606,2400,RF434015835
M16700558,2021-11-29T00:00:00+05:30,2021-11-29,NEFT-SBIN421332899339-MR  ND KL AL-/ATTN//INB-0000003325266545,CREDIT,FT,127527.606,3000,RF435015836
M16710559,2021-11-30T00:00:00+05:30,2021-11-30,UPI/133463702131/Payment from Ph/9620986689@ybl/ICICI Bank/YBL1df763be42f2451b9,CREDIT,UPI,139527.606,12000,RF436015837
M16720560,2021-12-01T00:00:00+05:30,2021-12-01,UPI/133509943006/payment on CRED/credclub@icici/IC,DEBIT,UPI,113065.806,26461.8,RF437015838
M16730561,2021-12-01T00:00:00+05:30,2021-12-01,UPI/133563620994/payment on CRED/credclub@icici/IC,DEBIT,UPI,106344.702,6721.104,RF438015839
M16740562,2021-12-01T00:00:00+05:30,2021-12-01,BIL/NEFT/000268473167/Loan Repay/NAVRANG BH/SBIN00,DEBIT,OTHERS,94344.702,12000,RF439015840
M16750563,2021-12-03T00:00:00+05:30,2021-12-03,UPI/133722115693/Chetan refund/suman71911@okic/ICICI Bank/ICI119551a7d63e4183b9,DEBIT,UPI,87972.702,6372,RF440015841
M16760564,2021-12-08T00:00:00+05:30,2021-12-08,MMT/IMPS/134210783418/Bhagat Kaka/Bhagat Man/YESB0,DEBIT,OTHERS,57972.702,30000,RF441015842
M16770565,2021-12-08T00:00:00+05:30,2021-12-08,MMT/IMPS/134210783418/Bhagat Kaka/Bhagat Man/YESB0,CREDIT,OTHERS,87972.702,30000,RF442015843
M16780566,2021-12-08T00:00:00+05:30,2021-12-08,BIL/NEFT/000275398441/Bhagat Kaka/Bhagat Man/YESB0,DEBIT,OTHERS,57972.702,30000,RF443015844
M16790567,2021-12-08T00:00:00+05:30,2021-12-08,NEFT-0001223422101865-TREK THE HIMALAYAS-DAYARA REFUND-1221000000000050-NTBL0TA,CREDIT,FT,61059.702,3087,RF444015845
M16800568,2021-12-08T00:00:00+05:30,2021-12-08,UPI/134209769807/cab/olamoney1.payu@/HDFC BANK LTD/ICIfd629fcf836c4165b6debdd64,DEBIT,UPI,60904.302,155.4,RF445015846
M16810569,2021-12-09T00:00:00+05:30,2021-12-09,UPI/134316843746/doc/vitalifehealths/HDFC BANK LTD/ICIce6fa80d594d4b4fb017c50cb,DEBIT,UPI,60544.302,360,RF446015847
M16820570,2021-12-09T00:00:00+05:30,2021-12-09,UPI/134375859082/Parking/Q43554145@ybl/Bank of Baroda/YBL04f8bf1764154450ae1c4e,DEBIT,UPI,60532.302,12,RF447015848
M16830571,2021-12-09T00:00:00+05:30,2021-12-09,UPI/134327667540/chauhan towel/ekta9n@okicici/ICICI Bank/ICI421fc935ed63483d9fd,CREDIT,UPI,61012.302,480,RF448015849
M16840572,2021-12-13T00:00:00+05:30,2021-12-13,UPI/134551195487/lunch/gpay-1117671126/Axis Bank Ltd./ICI604d990e21ed4795982a23,DEBIT,UPI,60904.302,108,RF449015850
M16850573,2021-12-14T00:00:00+05:30,2021-12-14,NEFT-SBIN221348113890-SBI FUNDS MANAGEMENT PRIVATE LIMITE-/ATTN//INB-0000004000,CREDIT,FT,61506.606,602.304,RF450015851
M16860574,2021-12-15T00:00:00+05:30,2021-12-15,ACH/LICHOUSINGFINLTD/620500010790:31059795        ,DEBIT,FT,15431.406,46075.2,RF451015852
M16870575,2021-12-15T00:00:00+05:30,2021-12-15,UPI/134942279488/BhartiAirtelLim/bhartiairtel.rz/State Bank Of I/YBL39920cca509,DEBIT,UPI,15396.606,34.8,RF452015853
M16880576,2021-12-18T00:00:00+05:30,2021-12-18,UPI/135220192419/UPI Intent/1mgtechnologies/Paytm Payments /YBL1939f3899dbb4d27,DEBIT,UPI,15119.586,277.02,RF453015854
M16890577,2021-12-20T00:00:00+05:30,2021-12-20,UPI/135372342598/Oct Nov Bill/dineshchandraga/State Bank Of I/ICI5b2c9a10683946,DEBIT,UPI,14735.586,384,RF454015855
M16900578,2021-12-20T00:00:00+05:30,2021-12-20,UPI/135442569751/BhartiAirtelLim/airtelin.rzp@ic/ICICI Bank/YBL596a70678c244817,DEBIT,UPI,14304.186,431.4,RF455015856
M16910579,2021-12-22T00:00:00+05:30,2021-12-22,UPI/135649174531/Panipuri/paytmqr28100505/Paytm Payments /YBLf285e2ac9a3a473599,DEBIT,UPI,14274.186,30,RF456015857
M16920580,2021-12-27T00:00:00+05:30,2021-12-27,UPI/135929880790/Baddy strings/7547050505@okbi/Axis Bank Ltd./YBL77bdf070db4e40,DEBIT,UPI,13512.786,761.4,RF457015858
M16930581,2021-12-27T00:00:00+05:30,2021-12-27,UPI/135970125660/baddy shuttles/7547050505@okbi/Axis Bank Ltd./ICIf8e092388c904,DEBIT,UPI,12925.386,587.4,RF458015859
M16940582,2021-12-27T00:00:00+05:30,2021-12-27,UPI/135971087197/NA/paytmqr28100505//ICI1a597f804c,DEBIT,UPI,12709.386,216,RF459015860
M16950583,2021-12-27T00:00:00+05:30,2021-12-27,UPI/136000582268/Payment for NM1/NETMEDS@ybl/Yes Bank Ltd/YBLe5c4a825bd3a43cc82,DEBIT,UPI,12370.212,339.174,RF460015861
M16960584,2021-12-27T00:00:00+05:30,2021-12-27,UPI/136084167351/Pay to BharatPe/bharatpe9072231/Yes Bank Ltd/ICIcdd56632642245,DEBIT,UPI,12340.212,30,RF461015862
M16970585,2021-12-27T00:00:00+05:30,2021-12-27,UPI/136033568351/DecathlonSports/decathlonsports/ICICI Bank/YBLa236ec58af4b42e4,DEBIT,UPI,10243.812,2096.4,RF462015863
M16980586,2021-12-28T00:00:00+05:30,2021-12-28,UPI/136288310167/Meds/Q60278127@ybl/State Bank Of I/YBL822c71b7c6d140909afc9678,DEBIT,UPI,9691.812,552,RF463015864
M16990587,2021-12-29T00:00:00+05:30,2021-12-29,UPI/136351853367/Paan/paytmqr28100505/Paytm Payments /YBLafbf521fc68d4deba8bf6b,DEBIT,UPI,9619.812,72,RF464015865
M17000588,2021-12-31T00:00:00+05:30,2021-12-31,238801500178:Int.Pd:30-09-2021 to 30-12-2021      ,CREDIT,OTHERS,10398.012,778.2,RF465015866
M17010589,2021-12-31T00:00:00+05:30,2021-12-31,UPI/136546469962/Rahul park/paytmqr28100505/Paytm Payments /YBL777640763c424398,DEBIT,UPI,10374.012,24,RF466015867
M17020590,2021-12-31T00:00:00+05:30,2021-12-31,UPI/136519330027/Cab/Q19879492@ybl/Bank of Baroda/YBL43d9e1410ba1456ea793a7a028,DEBIT,UPI,10255.812,118.2,RF467015868
M17030591,2021-12-31T00:00:00+05:30,2021-12-31,UPI/136557057061/Verified Mercha/BHARATPE.904175/ICICI Bank/YBLde8104244da84330,DEBIT,UPI,9895.812,360,RF468015869
M17040592,2021-12-31T00:00:00+05:30,2021-12-31,UPI/136544321871/Paan/paytmqr28100505/Paytm Payments /YBLe47440c0058a4f9b9ab587,DEBIT,UPI,9790.812,105,RF469015870
M17050593,2022-01-01T00:00:00+05:30,2022-01-01,UPI/200133865749/Payment from Ph/9620986689@ybl/ICICI Bank/YBLd9db9f71d57e4c74a,CREDIT,UPI,15790.812,6000,RF470015871
M17060594,2022-01-03T00:00:00+05:30,2022-01-03,UPI/200269137310/Payment from Ph/9620986689@ybl/ICICI Bank/YBLe8b2bfee15c2470db,CREDIT,UPI,45790.812,30000,RF471015872
M17070595,2022-01-03T00:00:00+05:30,2022-01-03,BIL/INFT/000293870898/Family/                     ,CREDIT,OTHERS,105790.812,60000,RF472015873
M17080596,2022-01-03T00:00:00+05:30,2022-01-03,UPI/200268120403/payment on CRED/credcc@yesbank/Yes Bank Ltd/eulkdfZAJUCHq6S3Mc,DEBIT,UPI,94624.812,11166,RF473015874
M17090597,2022-01-03T00:00:00+05:30,2022-01-03,UPI/200212185648/payment on CRED/credclub@icici/IC,DEBIT,UPI,60499.416,34125.396,RF474015875
M17100598,2022-01-03T00:00:00+05:30,2022-01-03,MMT/IMPS/200310959573/Edu Loan Repaym/NAVRANG BH/S,DEBIT,OTHERS,48499.416,12000,RF475015876